-1,-1,-1,-1,-1,-1,-1,-1,-1,-1,-1,-1,-1,-1,-1,-1,-1,-1,-1,-1,-1,-1,-1,-1,-1,-1,-1,-1,-1,-1,-1,-1,-1,-1,-1,-1,-1,-1,-1,-1,-1,-1,-1,-1,-1,-1,-1,-1,-1,-1,-1,-1,-1,-1,-1,-1,-1,-1,-1,-1,-1,-1,-1,-1,-1,-1,-1,-1,-1,-1,-1,-1,-1,-1,-1,-1,-1,-1,-1,-1,-1,-1,-1,-1,-1,-1,-1,-1,-1,-1,-1,-1,-1,-1,-1,-1,-1,-1,-1,-1,-1,-1,-1,-1,-1,-1,-1,-1,-1,-1,-1,-1,-1,-1,-1,-1,-1,-1,-1,-1,-1,-1,27,28,-1,-1,-1,-1,-1,-1,-1,-1,-1,-1,-1,-1,-1,-1,-1,-1,-1,-1,-1,-1,-1,-1,-1,-1,-1,-1
12,0,1,3,-1,-1,-1,-1,-1,7,7,7,7,7,7,7,-1,-1,-1,-1,-1,0,1,3,-1,-1,-1,-1,-1,-1,-1,-1,-1,-1,-1,-1,-1,-1,-1,-1,-1,-1,-1,-1,-1,-1,-1,-1,-1,-1,-1,-1,-1,-1,-1,-1,-1,-1,-1,-1,-1,-1,-1,-1,-1,27,24,29,-1,-1,-1,-1,-1,-1,73,73,74,73,73,-1,-1,-1,-1,-1,-1,0,1,3,-1,-1,-1,-1,-1,-1,-1,-1,-1,-1,-1,0,1,1,1,1,3,-1,-1,-1,-1,-1,-1,-1,-1,-1,-1,0,1,1,1,1,3,-1,13,11,-1,-1,-1,-1,-1,-1,-1,-1,-1,-1,-1,-1,-1,-1,-1,11,-1,-1,-1,-1,-1,-1,-1,-1,-1,-1
12,12,10,21,-1,36,36,36,-1,7,-1,33,-1,33,-1,7,-1,36,36,36,-1,9,10,11,-1,-1,-1,-1,-1,-1,-1,-1,-1,-1,-1,-1,-1,-1,-1,-1,-1,-1,-1,-1,70,69,71,-1,-1,-1,-1,-1,-1,-1,-1,-1,-1,-1,-1,-1,-1,-1,-1,-1,-1,13,10,14,-1,-1,-1,-1,-1,-1,33,33,33,33,33,-1,-1,-1,-1,-1,-1,9,10,14,-1,-1,-1,-1,-1,-1,-1,-1,-1,-1,-1,12,-1,7,73,-1,21,-1,-1,-1,76,72,72,76,-1,-1,-1,12,-1,73,7,-1,21,-1,18,20,-1,-1,-1,-1,-1,-1,-1,-1,-1,82,-1,-1,-1,-1,-1,11,-1,-1,-1,-1,-1,-1,-1,-1,-1,-1
12,18,19,20,-1,-1,-1,-1,-1,7,65,33,65,33,65,7,-1,-1,-1,-1,-1,18,19,20,-1,-1,-1,-1,72,74,-1,76,-1,-1,-1,-1,-1,-1,-1,-1,-1,-1,-1,-1,27,10,29,-1,-1,77,-1,-1,-1,-1,-1,-1,-1,78,-1,-1,-1,-1,-1,-1,-1,18,19,20,-1,-1,-1,-1,-1,-1,33,78,10,78,33,-1,-1,-1,-1,-1,-1,18,19,20,-1,-1,-1,-1,-1,-1,27,28,-1,-1,-1,12,-1,-1,7,73,21,-1,-1,-1,27,15,15,29,-1,-1,-1,12,73,7,-1,-1,21,-1,27,29,-1,-1,-1,-1,-1,-1,-1,-1,-1,-1,-1,-1,-1,-1,-1,11,-1,-1,-1,-1,-1,-1,-1,-1,-1,-1
12,-1,-1,-1,-1,-1,-1,-1,-1,7,7,7,7,7,7,7,-1,-1,-1,-1,-1,-1,-1,-1,-1,-1,-1,-1,7,33,7,33,79,-1,-1,-1,-1,-1,82,-1,-1,-1,65,71,4,4,4,66,75,67,-1,-1,-1,81,-1,-1,-1,68,72,-1,-1,-1,-1,-1,-1,-1,36,-1,-1,-1,-1,-1,-1,-1,33,68,10,68,33,-1,-1,-1,-1,-1,-1,-1,36,-1,-1,-1,-1,-1,-1,-1,9,11,-1,-1,-1,12,-1,-1,-1,7,21,-1,-1,-1,9,33,33,11,-1,-1,-1,12,7,-1,-1,-1,21,-1,9,11,-1,-1,-1,-1,-1,37,38,38,38,38,38,38,38,-1,-1,11,-1,-1,-1,-1,-1,60,-1,86,-1,88
12,-1,-1,-1,-1,-1,-1,-1,-1,-1,-1,-1,-1,-1,-1,-1,-1,-1,-1,-1,-1,-1,-1,-1,-1,-1,-1,-1,-1,-1,-1,7,33,7,33,7,33,7,33,7,33,7,33,7,33,7,33,7,33,7,33,7,33,7,33,7,33,7,33,-1,-1,-1,-1,-1,-1,-1,36,-1,-1,-1,-1,-1,-1,-1,33,33,33,33,33,-1,-1,-1,-1,-1,-1,-1,36,-1,-1,-1,-1,-1,-1,-1,18,20,-1,-1,-1,18,19,19,19,19,20,-1,-1,-1,18,19,19,20,-1,-1,-1,18,19,19,19,19,20,-1,18,20,-1,61,61,-1,-1,-1,-1,-1,-1,-1,-1,0,29,-1,-1,11,78,-1,-1,-1,-1,33,33,33,66,88
12,-1,-1,-1,-1,-1,-1,-1,-1,-1,-1,-1,-1,-1,-1,-1,-1,-1,-1,-1,-1,-1,-1,-1,36,36,-1,-1,-1,-1,-1,-1,-1,-1,-1,-1,-1,0,3,-1,-1,-1,-1,-1,-1,-1,-1,-1,-1,-1,-1,-1,-1,-1,-1,-1,-1,-1,-1,-1,-1,-1,-1,-1,-1,-1,36,-1,-1,-1,-1,-1,-1,-1,-1,-1,-1,-1,-1,-1,-1,-1,-1,-1,-1,-1,36,-1,-1,-1,-1,-1,-1,-1,27,29,-1,-1,-1,-1,-1,-1,-1,-1,-1,-1,-1,-1,-1,-1,-1,-1,-1,-1,-1,-1,-1,-1,-1,-1,-1,-1,0,3,-1,7,7,-1,-1,77,-1,-1,-1,-1,-1,9,11,-1,-1,11,68,72,75,-1,-1,-1,-1,33,33,75
12,-1,-1,-1,-1,-1,-1,-1,-1,-1,-1,-1,-1,-1,-1,-1,-1,-1,-1,-1,-1,-1,-1,-1,-1,-1,-1,76,-1,-1,-1,-1,-1,-1,-1,-1,-1,13,21,-1,-1,-1,-1,-1,-1,-1,-1,-1,-1,-1,-1,-1,-1,-1,-1,-1,-1,-1,-1,-1,-1,-1,-1,-1,-1,-1,-1,-1,-1,-1,-1,-1,-1,-1,-1,-1,-1,-1,-1,-1,-1,-1,-1,-1,-1,-1,-1,-1,-1,-1,-1,-1,-1,-1,9,11,-1,-1,-1,-1,-1,-1,-1,-1,-1,-1,-1,-1,-1,-1,-1,-1,-1,-1,-1,-1,-1,-1,-1,-1,-1,-1,9,11,-1,-1,-1,-1,-1,67,66,-1,-1,-1,-1,18,20,-1,-1,11,33,33,33,-1,-1,-1,-1,-1,33,33
12,-1,-1,-1,-1,-1,-1,-1,-1,-1,-1,-1,-1,-1,-1,-1,-1,-1,-1,-1,-1,-1,-1,-1,-1,-1,-1,4,-1,87,-1,-1,-1,-1,-1,-1,-1,13,21,-1,-1,-1,-1,-1,-1,-1,-1,-1,-1,-1,-1,-1,-1,-1,-1,-1,-1,-1,-1,-1,-1,-1,-1,-1,-1,-1,-1,-1,-1,-1,-1,-1,-1,-1,-1,-1,-1,-1,-1,-1,-1,-1,-1,-1,-1,-1,-1,-1,-1,-1,-1,-1,-1,-1,18,20,-1,-1,-1,-1,-1,-1,-1,-1,-1,-1,-1,-1,-1,-1,-1,-1,-1,-1,-1,-1,-1,-1,-1,-1,-1,-1,18,20,-1,-1,-1,-1,42,43,34,-1,-1,-1,74,0,3,-1,-1,11,-1,-1,-1,33,65,-1,-1,-1,-1,21
12,-1,-1,-1,-1,-1,-1,-1,-1,-1,-1,-1,-1,-1,-1,-1,-1,-1,-1,-1,-1,-1,-1,-1,-1,-1,-1,-1,57,49,59,-1,-1,-1,-1,-1,-1,13,21,-1,51,52,-1,-1,-1,-1,-1,-1,-1,-1,-1,-1,-1,-1,-1,-1,82,-1,-1,-1,-1,-1,-1,-1,-1,-1,-1,-1,-1,-1,-1,-1,-1,-1,61,61,75,60,61,-1,-1,-1,-1,-1,-1,-1,-1,-1,-1,-1,-1,-1,-1,-1,-1,-1,-1,-1,-1,-1,-1,-1,-1,-1,-1,-1,-1,-1,-1,-1,-1,-1,-1,-1,-1,-1,-1,-1,-1,-1,-1,-1,-1,-1,-1,-1,-1,-1,-1,-1,-1,-1,-1,-1,33,9,11,-1,-1,-1,-1,-1,-1,-1,33,-1,-1,-1,-1,21
12,-1,-1,-1,-1,-1,-1,-1,-1,-1,51,52,-1,-1,45,46,47,-1,45,46,47,-1,-1,-1,-1,-1,-1,-1,-1,-1,51,52,-1,-1,-1,-1,-1,12,21,-1,-1,-1,-1,-1,86,-1,-1,-1,-1,-1,-1,-1,-1,-1,-1,-1,-1,-1,-1,-1,-1,-1,-1,-1,-1,-1,-1,-1,-1,-1,-1,-1,-1,-1,31,32,32,32,30,-1,-1,-1,-1,-1,-1,-1,-1,-1,-1,-1,-1,-1,-1,-1,-1,-1,-1,-1,-1,-1,-1,-1,-1,-1,-1,-1,-1,-1,-1,-1,-1,-1,-1,-1,-1,-1,-1,-1,-1,-1,-1,-1,-1,-1,-1,-1,-1,-1,-1,-1,-1,-1,-1,-1,-1,9,11,-1,-1,-1,-1,-1,-1,-1,-1,-1,-1,-1,76,21
12,-1,-1,-1,-1,-1,-1,-1,-1,-1,-1,-1,-1,-1,-1,-1,-1,-1,-1,-1,-1,-1,-1,-1,-1,-1,-1,-1,-1,-1,-1,-1,-1,-1,73,74,63,12,14,-1,-1,-1,-1,40,41,-1,-1,-1,-1,-1,-1,-1,-1,-1,-1,-1,-1,-1,-1,-1,-1,-1,-1,-1,-1,-1,12,-1,84,-1,-1,81,-1,21,-1,-1,-1,-1,-1,12,-1,-1,-1,81,-1,-1,21,-1,-1,-1,69,70,71,-1,-1,-1,-1,-1,-1,-1,-1,-1,-1,-1,-1,-1,-1,-1,-1,-1,-1,-1,-1,-1,-1,-1,-1,-1,-1,-1,-1,-1,75,69,-1,-1,-1,-1,-1,-1,-1,40,41,-1,-1,18,20,-1,-1,-1,-1,-1,-1,-1,-1,-1,-1,-1,33,21
12,-1,-1,-1,-1,-1,-1,36,-1,-1,-1,-1,-1,-1,-1,-1,-1,-1,-1,-1,-1,-1,72,36,75,72,-1,-1,-1,-1,-1,-1,-1,-1,8,35,54,12,14,-1,-1,-1,-1,-1,-1,-1,-1,-1,-1,-1,-1,-1,-1,64,74,-1,-1,-1,-1,-1,-1,-1,76,75,-1,-1,18,37,38,38,38,38,39,20,-1,-1,-1,-1,-1,18,37,38,38,38,38,39,20,-1,-1,-1,27,25,29,-1,75,64,-1,-1,-1,-1,-1,-1,-1,-1,-1,-1,-1,-1,-1,-1,-1,-1,-1,-1,-1,-1,-1,-1,-1,-1,-1,-1,0,3,-1,-1,37,38,39,-1,-1,-1,-1,-1,-1,27,29,-1,-1,-1,-1,-1,-1,-1,-1,-1,63,33,-1,21
12,-1,-1,-1,-1,-1,27,24,28,-1,-1,77,-1,-1,-1,-1,-1,-1,-1,-1,-1,-1,0,1,3,36,-1,-1,-1,-1,-1,-1,-1,36,17,44,55,12,14,-1,-1,-1,-1,-1,-1,-1,-1,4,-1,-1,-1,-1,27,25,28,-1,-1,-1,-1,-1,-1,77,8,35,54,-1,-1,-1,-1,-1,-1,-1,-1,-1,-1,-1,-1,-1,-1,-1,-1,-1,-1,-1,-1,-1,-1,-1,-1,-1,9,10,11,-1,0,3,78,-1,-1,-1,-1,-1,-1,-1,-1,-1,-1,-1,-1,-1,-1,-1,-1,-1,-1,-1,-1,-1,-1,-1,-1,78,9,11,-1,-1,-1,-1,-1,-1,-1,-1,-1,-1,-1,9,11,51,52,-1,-1,-1,-1,-1,-1,-1,33,-1,-1,21
12,70,80,60,61,61,42,43,34,61,61,67,60,61,61,61,81,61,66,63,61,61,33,33,33,61,61,61,61,60,81,61,62,79,26,53,56,18,20,63,61,61,76,81,61,61,65,4,-1,-1,-1,-1,33,33,33,61,61,61,61,-1,60,67,17,44,55,-1,-1,-1,-1,-1,-1,-1,-1,-1,-1,-1,-1,-1,-1,-1,-1,-1,-1,-1,-1,-1,-1,-1,-1,-1,18,19,20,-1,9,11,68,64,61,60,61,74,61,62,61,73,61,63,61,72,61,66,61,85,61,82,61,65,61,33,61,68,18,20,-1,-1,-1,-1,-1,-1,-1,-1,-1,-1,-1,9,11,-1,-1,-1,-1,57,49,59,-1,-1,-1,-1,-1,-1
4,4,4,4,4,4,4,4,4,4,4,4,4,4,4,4,4,4,4,4,4,4,4,4,4,4,4,4,4,4,4,4,4,4,4,4,4,4,4,4,4,4,4,4,4,4,4,4,-1,-1,-1,-1,4,4,4,4,4,4,4,4,4,4,26,53,56,-1,-1,-1,-1,-1,-1,-1,-1,-1,-1,-1,-1,-1,-1,-1,-1,-1,-1,-1,-1,-1,-1,-1,-1,-1,-1,-1,-1,-1,18,20,4,4,4,4,4,4,4,4,4,4,4,4,4,4,4,4,4,4,4,4,4,4,4,4,4,4,4,4,-1,-1,-1,-1,-1,-1,-1,-1,-1,-1,-1,18,20,-1,-1,-1,-1,-1,-1,-1,-1,-1,-1,-1,-1,-1
